AA	ɑ
AE	æ
AH0	ə
AH1	ʌ
AH2	ʌ
AO	ɔ
AW	aʊ
AY	aɪ
B	b
CH	tʃ
D	d
DH	ð
EH	ɛ
ER	ɝ
ER0	ɚ
EY	eɪ
F	f
G	ɡ
HH	h
IH	ɪ
IY	i
JH	dʒ
K	k
L	l
M	m
N	n
NG	ŋ
OW	oʊ
OY	ɔɪ
P	p
R	ɹ
S	s
SH	ʃ
T	t
TH	θ
UH	ʊ
UW	u
V	v
W	w
Y	j
Z	z
ZH	ʒ
